00 00 00 00 00 00 00 00
00 00 00 00 00 00 00 00
00 00 00 00 00 00 00 00
00 00 00 00 00 00 00 00
00 00 00 00 00 00 00 00
00 00 00 00 00 00 00 00
00 00 00 00 00 00 00 00
28 19 40 00 00 00 00 00
49 18 40 00 00 00 00 00
5f 18 40 00 00 00 00 00
48 00 00 00 00 00 00 00
f4 18 40 00 00 00 00 00
83 18 40 00 00 00 00 00
7c 18 40 00 00 00 00 00
75 18 40 00 00 00 00 00
49 18 40 00 00 00 00 00
ab 17 40 00 00 00 00 00
36 31 32 36 36 33 63 35
00 00 00 00 00 00 00 00